
*****
**X*A
*DX**
**X**
**X**
*****
